%%%%%%%%%%%%%%%%%%%%
%o...%........%...o%
%.%%.%.%%..%%.%.%%.%
%.%.....%..%.....%.%
%.%.%%.%%  %%.%%.%.%
%...... G   %.%....%
%.%....%%%%%%.%..%.%
%.%....%  oo%.%..%.%
%.%....% %%%%.%..%.%
%.%G..........%..%.%
%.%%.%.%%%%%%.%.%%.%
%o...%...P....%...o%
%%%%%%%%%%%%%%%%%%%%
