%%%%%%%%%%%%%%%%%%%%
%o...%........%2..o%
%.%%.%.%%..%%.%.%%.%
%.%.....%..%.....%.%
%.%.%%.%%  %%.%%.%.%
%...... 2   %.%....%
%.%....%%%%%%.%..%.%
%.%....%  oo%.%..%.%
%.%....% %%%%.%..%.%
%.%G..........%..%.%
%.%%.%.%%%%%%.%.%%.%
%o...%...P....%...o%
%%%%%%%%%%%%%%%%%%%%
